68 15
########################                                          ##
##                                                                ##
##S                                                              F##
#########################                         #       #######$##
    ##        ##       ##   ###                #          ##########
    ##        ##        ##       ###         #            ##########
    ##        ##       ##               ###               ##########
    ##        ##        ##      #   ##                    ##########
    ##        ##       ##      ##            #######################
    ##        ##        ############################################
####################################################################
                                                                    
####################################################################
####################################################################
####################################################################




